race,total_cases,total cases/group population,deaths,total deaths/group population,date,doses/group population,total_doses,cumulative_total_doses,pfizer doses,moderna doses,jj doses,total_partially_vaccinated,cumulative_fully_vaccinated,cumulative_at_least_one_dose
American Indian or Alaska Native,3828,0.000193267,70,3.53E-06,12/16/20,0.000308765,58,61,61,0,0,61,0,61
American Indian or Alaska Native,3908,0.000197306,72,3.64E-06,12/17/20,0.000647901,67,128,128,0,0,128,0,128
American Indian or Alaska Native,4042,0.000204072,74,3.74E-06,12/18/20,0.001275555,124,252,252,0,0,252,0,252
American Indian or Alaska Native,4157,0.000209878,74,3.74E-06,12/19/20,0.001574197,59,311,311,0,0,311,0,311
American Indian or Alaska Native,4253,0.000214725,74,3.74E-06,12/20/20,0.00178679,42,353,353,0,0,353,0,353
American Indian or Alaska Native,4352,0.000219723,74,3.74E-06,12/21/20,0.002662469,173,526,520,6,0,526,0,526
American Indian or Alaska Native,4423,0.000223308,75,3.79E-06,12/22/20,0.003391358,144,670,643,27,0,670,0,670
American Indian or Alaska Native,4423,0.000223308,75,3.79E-06,12/23/20,0.00442395,204,874,767,107,0,874,0,874
American Indian or Alaska Native,4655,0.000235021,78,3.94E-06,12/24/20,0.00480358,75,949,817,132,0,949,0,949
American Indian or Alaska Native,4739,0.000239262,79,3.99E-06,12/25/20,0.004818765,3,952,819,133,0,952,0,952
American Indian or Alaska Native,4848,0.000244765,80,4.04E-06,12/26/20,0.004985802,33,985,840,145,0,985,0,985
American Indian or Alaska Native,4950,0.000249915,82,4.14E-06,12/27/20,0.005183209,39,1024,861,163,0,1024,0,1024
American Indian or Alaska Native,5023,0.0002536,82,4.14E-06,12/28/20,0.006069012,175,1199,945,254,0,1199,0,1199
American Indian or Alaska Native,5090,0.000256983,81,4.09E-06,12/29/20,0.00700037,184,1383,1041,342,0,1383,0,1383
American Indian or Alaska Native,5090,0.000256983,81,4.09E-06,12/30/20,0.008534073,303,1686,1141,545,0,1686,0,1686
American Indian or Alaska Native,5242,0.000264657,82,4.14E-06,12/31/20,0.009273085,146,1832,1177,655,0,1832,0,1832
American Indian or Alaska Native,5358,0.000270514,85,4.29E-06,1/1/21,0.009323703,10,1842,1183,659,0,1842,0,1842
American Indian or Alaska Native,5444,0.000274856,85,4.29E-06,1/2/21,0.00963753,62,1904,1218,686,0,1904,0,1904
American Indian or Alaska Native,5498,0.000277582,85,4.29E-06,1/3/21,0.009713456,15,1919,1224,695,0,1919,0,1919
American Indian or Alaska Native,5583,0.000281874,86,4.34E-06,1/4/21,0.010720739,199,2118,1271,847,0,2118,0,2118
American Indian or Alaska Native,5646,0.000285054,87,4.39E-06,1/5/21,0.012001357,253,2371,1339,1032,0,2349,11,2360
American Indian or Alaska Native,5750,0.000290305,90,4.54E-06,1/6/21,0.013580616,312,2683,1461,1222,0,2529,77,2606
American Indian or Alaska Native,5926,0.000299191,91,4.59E-06,1/7/21,0.015873578,453,3136,1603,1533,0,2803,167,2970
American Indian or Alaska Native,6103,0.000308127,95,4.80E-06,1/8/21,0.018029874,426,3562,1773,1789,0,2993,285,3278
American Indian or Alaska Native,6261,0.000316104,96,4.85E-06,1/9/21,0.018530985,99,3661,1828,1833,0,3018,322,3340
American Indian or Alaska Native,6354,0.0003208,97,4.90E-06,1/10/21,0.018789133,51,3712,1858,1854,0,3025,344,3369
American Indian or Alaska Native,6420,0.000324132,97,4.90E-06,1/11/21,0.021021355,441,4153,2083,2070,0,3181,487,3668
American Indian or Alaska Native,6509,0.000328625,99,5.00E-06,1/12/21,0.023749627,539,4692,2294,2398,0,3522,586,4108
American Indian or Alaska Native,6595,0.000332967,99,5.00E-06,1/13/21,0.026462713,536,5228,2507,2721,0,3844,693,4537
American Indian or Alaska Native,6699,0.000338218,102,5.15E-06,1/14/21,0.029788268,657,5885,2677,3208,0,4398,745,5143
American Indian or Alaska Native,6840,0.000345337,101,5.10E-06,1/15/21,0.03254691,545,6430,2835,3595,0,4865,785,5650
American Indian or Alaska Native,6957,0.000351244,101,5.10E-06,1/16/21,0.033635181,215,6645,2901,3744,0,5044,803,5847
American Indian or Alaska Native,7041,0.000355485,102,5.15E-06,1/17/21,0.034050243,82,6727,2934,3793,0,5106,813,5919
American Indian or Alaska Native,7106,0.000358767,102,5.15E-06,1/18/21,0.035224564,232,6959,3076,3883,0,5232,866,6098
American Indian or Alaska Native,7155,0.00036124,102,5.15E-06,1/19/21,0.038808267,708,7667,3308,4359,0,5689,991,6680
American Indian or Alaska Native,7242,0.000365633,107,5.40E-06,1/20/21,0.04242234,714,8381,3591,4790,0,6158,1113,7271
American Indian or Alaska Native,7336,0.000370379,110,5.55E-06,1/21/21,0.045919994,691,9072,3841,5231,0,6736,1170,7906
American Indian or Alaska Native,7387,0.000372954,110,5.55E-06,1/22/21,0.049002587,609,9681,4076,5605,0,7229,1228,8457
American Indian or Alaska Native,7480,0.000377649,112,5.65E-06,1/23/21,0.051017154,398,10079,4149,5930,0,7566,1259,8825
American Indian or Alaska Native,7573,0.000382344,112,5.65E-06,1/24/21,0.051700487,135,10214,4214,6000,0,7688,1265,8953
American Indian or Alaska Native,7614,0.000384414,117,5.91E-06,1/25/21,0.054018759,458,10672,4363,6309,0,7923,1377,9300
American Indian or Alaska Native,7664,0.000386939,117,5.91E-06,1/26/21,0.057911227,769,11441,4593,6848,0,8421,1513,9934
American Indian or Alaska Native,7719,0.000389716,120,6.06E-06,1/27/21,0.061130486,636,12077,4838,7239,0,8784,1650,10434
American Indian or Alaska Native,7770,0.000392291,121,6.11E-06,1/28/21,0.065281103,820,12897,5118,7779,0,9335,1785,11120
American Indian or Alaska Native,7837,0.000395673,123,6.21E-06,1/29/21,0.068439621,624,13521,5322,8199,0,9712,1908,11620
American Indian or Alaska Native,7909,0.000399308,126,6.36E-06,1/30/21,0.069877152,284,13805,5444,8361,0,9931,1940,11871
American Indian or Alaska Native,7955,0.000401631,128,6.46E-06,1/31/21,0.070600979,143,13948,5527,8421,0,10046,1954,12000
American Indian or Alaska Native,7990,0.000403398,130,6.56E-06,2/1/21,0.073339374,541,14489,5720,8769,0,10291,2102,12393
American Indian or Alaska Native,8029,0.000405367,135,6.82E-06,2/2/21,0.077930361,907,15396,5982,9414,0,10821,2290,13111
American Indian or Alaska Native,8079,0.000407891,138,6.97E-06,2/3/21,0.082035422,811,16207,6250,9957,0,11043,2584,13627
American Indian or Alaska Native,8140,0.000410971,141,7.12E-06,2/4/21,0.086839002,949,17156,6518,10638,0,11312,2924,14236
American Indian or Alaska Native,8183,0.000413142,145,7.32E-06,2/5/21,0.091860236,992,18148,6859,11289,0,11482,3334,14816
American Indian or Alaska Native,8219,0.00041496,145,7.32E-06,2/6/21,0.09459863,541,18689,7032,11657,0,11856,3418,15274
American Indian or Alaska Native,8252,0.000416626,145,7.32E-06,2/7/21,0.09530221,139,18828,7110,11718,0,11921,3455,15376
American Indian or Alaska Native,8284,0.000418241,146,7.37E-06,2/8/21,0.098890975,709,19537,7352,12185,0,12057,3742,15799
American Indian or Alaska Native,8320,0.000420059,150,7.57E-06,2/9/21,0.10400332,1010,20547,7676,12871,0,12247,4153,16400
American Indian or Alaska Native,8351,0.000421624,153,7.72E-06,2/10/21,0.108827147,953,21500,8068,13432,0,12210,4646,16856
American Indian or Alaska Native,8392,0.000423694,154,7.78E-06,2/11/21,0.115528875,1324,22824,8469,14355,0,12329,5247,17576
American Indian or Alaska Native,8456,0.000426925,158,7.98E-06,2/12/21,0.121380232,1156,23980,8850,15130,0,12532,5724,18256
American Indian or Alaska Native,8506,0.00042945,158,7.98E-06,2/13/21,0.123799738,478,24458,9010,15448,0,12747,5857,18604
American Indian or Alaska Native,8537,0.000431015,160,8.08E-06,2/14/21,0.125090478,255,24713,9124,15589,0,12836,5941,18777
American Indian or Alaska Native,8549,0.000431621,160,8.08E-06,2/15/21,0.126786157,335,25048,9268,15780,0,12903,6077,18980
American Indian or Alaska Native,8561,0.000432226,162,8.18E-06,2/16/21,0.132323687,1094,26142,9579,16563,0,13074,6545,19619
American Indian or Alaska Native,8574,0.000432883,163,8.23E-06,2/17/21,0.137015909,927,27069,9891,17178,0,13088,7005,20093
American Indian or Alaska Native,8612,0.000434801,163,8.23E-06,2/18/21,0.142669859,1117,28186,10350,17836,0,12982,7619,20601
American Indian or Alaska Native,8653,0.000436871,165,8.33E-06,2/19/21,0.146759735,808,28994,10794,18200,0,12981,8026,21007
American Indian or Alaska Native,8681,0.000438285,166,8.38E-06,2/20/21,0.150090352,658,29652,11042,18610,0,12968,8363,21331
American Indian or Alaska Native,8701,0.000439295,165,8.33E-06,2/21/21,0.150971092,174,29826,11170,18656,0,13011,8429,21440
American Indian or Alaska Native,8714,0.000439951,165,8.33E-06,2/22/21,0.153820845,563,30389,11466,18923,0,13060,8690,21750
American Indian or Alaska Native,8740,0.000441264,165,8.33E-06,2/23/21,0.159181215,1059,31448,11898,19550,0,13109,9202,22311
American Indian or Alaska Native,8770,0.000442778,167,8.43E-06,2/24/21,0.164121461,976,32424,12276,20148,0,13066,9721,22787
American Indian or Alaska Native,8813,0.000444949,171,8.63E-06,2/25/21,0.170747263,1309,33733,12731,21002,0,12985,10427,23412
American Indian or Alaska Native,8835,0.00044606,172,8.68E-06,2/26/21,0.177150348,1265,34998,13261,21737,0,13181,10967,24148
American Indian or Alaska Native,8861,0.000447373,173,8.73E-06,2/27/21,0.18061257,684,35682,13585,22097,0,13367,11224,24591
American Indian or Alaska Native,8882,0.000448433,174,8.78E-06,2/28/21,0.182536027,380,36062,13847,22215,0,13571,11318,24889
American Indian or Alaska Native,8894,0.000449039,174,8.78E-06,3/1/21,0.186134915,711,36773,14184,22589,0,13719,11602,25321
American Indian or Alaska Native,8915,0.000450099,173,8.73E-06,3/2/21,0.190867631,935,37708,14511,23197,0,13906,11985,25891
American Indian or Alaska Native,8929,0.000450806,176,8.89E-06,3/3/21,0.196643062,1141,38849,14983,23866,0,14125,12462,26587
American Indian or Alaska Native,8972,0.000452977,180,9.09E-06,3/4/21,0.203385284,1332,40181,15506,24675,0,14079,13156,27235
American Indian or Alaska Native,9004,0.000454593,183,9.24E-06,3/5/21,0.2087659,1063,41244,16043,25193,8,14400,13537,27937
American Indian or Alaska Native,9025,0.000455653,184,9.29E-06,3/6/21,0.21330627,897,42141,16400,25700,41,14525,13944,28469
American Indian or Alaska Native,9045,0.000456663,184,9.29E-06,3/7/21,0.215098122,354,42495,16609,25816,70,14684,14060,28744
American Indian or Alaska Native,9053,0.000457066,185,9.34E-06,3/8/21,0.219071578,785,43280,16924,26230,126,14972,14341,29313
American Indian or Alaska Native,9163,0.00046262,187,9.44E-06,3/9/21,0.224659725,1104,44384,17255,26933,196,15169,14838,30007
American Indian or Alaska Native,9183,0.00046363,188,9.49E-06,3/10/21,0.229756885,1007,45391,17709,27381,301,15369,15297,30666
American Indian or Alaska Native,9208,0.000464892,191,9.64E-06,3/11/21,0.237562069,1542,46933,18244,28255,434,15501,16073,31574
American Indian or Alaska Native,9237,0.000466356,193,9.74E-06,3/12/21,0.245250834,1519,48452,18790,29053,609,15562,16894,32456
American Indian or Alaska Native,9255,0.000467265,192,9.69E-06,3/13/21,0.249649475,869,49321,19172,29438,711,15802,17266,33068
American Indian or Alaska Native,9262,0.000467618,192,9.69E-06,3/14/21,0.251937376,452,49773,19411,29590,772,15900,17477,33377
American Indian or Alaska Native,9267,0.000467871,192,9.69E-06,3/15/21,0.256174042,837,50610,19819,29953,838,16124,17822,33946
American Indian or Alaska Native,9289,0.000468982,193,9.74E-06,3/16/21,0.262997251,1348,51958,20343,30662,953,16482,18377,34859
American Indian or Alaska Native,9312,0.000470143,198,1.00E-05,3/17/21,0.269774905,1339,53297,20971,31292,1034,16726,18969,35695
American Indian or Alaska Native,9328,0.000470951,199,1.00E-05,3/18/21,0.27699799,1427,54724,21540,32075,1109,16890,19639,36529
American Indian or Alaska Native,9348,0.00047196,198,1.00E-05,3/19/21,0.283552928,1295,56019,22162,32673,1184,17082,20231,37313
American Indian or Alaska Native,9387,0.000473929,200,1.01E-05,3/20/21,0.287809841,841,56860,22589,33045,1226,17272,20579,37851
American Indian or Alaska Native,9405,0.000474838,201,1.01E-05,3/21/21,0.290188853,470,57330,22950,33122,1258,17312,20812,38124
American Indian or Alaska Native,9414,0.000475293,200,1.01E-05,3/22/21,0.294314161,815,58145,23391,33455,1299,17631,21085,38716
American Indian or Alaska Native,9416,0.000475393,200,1.01E-05,3/23/21,0.300570457,1236,59381,23946,34077,1358,18011,21547,39558
American Indian or Alaska Native,9429,0.00047605,202,1.02E-05,3/24/21,0.307429098,1355,60736,24672,34656,1408,18270,22121,40391
American Indian or Alaska Native,9452,0.000477211,201,1.01E-05,3/25/21,0.31522922,1541,62277,25296,35486,1495,18300,22923,41223
American Indian or Alaska Native,9473,0.000478271,202,1.02E-05,3/26/21,0.322680084,1472,63749,25987,36210,1552,18436,23621,42057
American Indian or Alaska Native,9501,0.000479685,205,1.04E-05,3/27/21,0.327154651,884,64633,26436,36584,1613,18451,24090,42541
American Indian or Alaska Native,9513,0.000480291,205,1.04E-05,3/28/21,0.32932107,428,65061,26723,36714,1624,18479,24299,42778
American Indian or Alaska Native,9518,0.000480543,204,1.03E-05,3/29/21,0.333972798,919,65980,27204,37121,1655,18621,24704,43325
American Indian or Alaska Native,9529,0.000481099,207,1.05E-05,3/30/21,0.340527736,1295,67275,27812,37760,1703,19042,25166,44208
American Indian or Alaska Native,9539,0.000481603,205,1.04E-05,3/31/21,0.346738476,1227,68502,28467,38249,1786,19277,25702,44979
American Indian or Alaska Native,9556,0.000482462,205,1.04E-05,4/1/21,0.354913166,1615,70117,29156,39037,1924,19514,26460,45974
American Indian or Alaska Native,9583,0.000483825,205,1.04E-05,4/2/21,0.361761684,1353,71470,29843,39587,2040,19656,27124,46780
American Indian or Alaska Native,9592,0.000484279,204,1.03E-05,4/3/21,0.36629193,895,72365,30281,39909,2175,19730,27603,47333
American Indian or Alaska Native,9597,0.000484532,202,1.02E-05,4/4/21,0.368033164,344,72709,30471,40009,2229,19709,27812,47521
American Indian or Alaska Native,9606,0.000484986,206,1.04E-05,4/5/21,0.37361625,1103,73812,31015,40425,2372,19816,28384,48200
American Indian or Alaska Native,9620,0.000485693,206,1.04E-05,4/6/21,0.381932669,1643,75455,31739,41103,2613,19976,29247,49223
American Indian or Alaska Native,9627,0.000486046,206,1.04E-05,4/7/21,0.389575878,1510,76965,32484,41610,2871,20279,29981,50260
American Indian or Alaska Native,9635,0.00048645,205,1.04E-05,4/8/21,0.399086864,1879,78844,33302,42386,3156,20442,30983,51425
American Indian or Alaska Native,9678,0.000488621,211,1.07E-05,4/9/21,0.407550073,1672,80516,34085,42988,3443,20600,31889,52489
American Indian or Alaska Native,9694,0.000489429,211,1.07E-05,4/10/21,0.413016739,1080,81596,34604,43346,3646,20621,32523,53144
American Indian or Alaska Native,9705,0.000489984,213,1.08E-05,4/11/21,0.415340072,460,82056,34875,43482,3699,20631,32778,53409
American Indian or Alaska Native,9709,0.000490186,214,1.08E-05,4/12/21,0.420133528,947,83003,35364,43826,3813,20762,33243,54005
American Indian or Alaska Native,9720,0.000490742,214,1.08E-05,4/13/21,0.426870688,1331,84334,36012,44503,3819,21039,33776,54815
American Indian or Alaska Native,9730,0.000491247,215,1.09E-05,4/14/21,0.432858712,1183,85517,36597,45099,3821,21057,34370,55427
American Indian or Alaska Native,9745,0.000492004,215,1.09E-05,4/15/21,0.439742662,1360,86877,37292,45762,3823,21088,35040,56128
American Indian or Alaska Native,9759,0.000492711,216,1.09E-05,4/16/21,0.445872414,1212,88089,37858,46407,3824,21144,35620,56764
American Indian or Alaska Native,9773,0.000493418,217,1.10E-05,4/17/21,0.449871179,790,88879,38300,46755,3824,21295,35943,57238
American Indian or Alaska Native,9779,0.000493721,217,1.10E-05,4/18/21,0.451521302,326,89205,38476,46905,3824,21287,36114,57401
American Indian or Alaska Native,9786,0.000494074,217,1.10E-05,4/19/21,0.456122413,909,90114,38991,47299,3824,21320,36554,57874
American Indian or Alaska Native,9796,0.000494579,217,1.10E-05,4/20/21,0.462510313,1263,91377,39642,47911,3824,21291,37203,58494
American Indian or Alaska Native,9816,0.000495589,215,1.09E-05,4/21/21,0.468341424,1153,92530,40213,48492,3825,21247,37808,59055
American Indian or Alaska Native,9818,0.00049569,215,1.09E-05,4/22/21,0.474263645,1180,93710,40809,49075,3826,21125,38462,59587
American Indian or Alaska Native,9827,0.000496144,215,1.09E-05,4/23/21,0.480332657,1200,94910,41383,49701,3826,21008,39131,60139
American Indian or Alaska Native,9841,0.000496851,218,1.10E-05,4/24/21,0.48444278,813,95723,41874,50023,3826,21110,39496,60606
American Indian or Alaska Native,9851,0.000497356,218,1.10E-05,4/25/21,0.486189076,345,96068,42107,50135,3826,21227,39612,60839
American Indian or Alaska Native,9857,0.000497659,218,1.10E-05,4/26/21,0.489944878,742,96810,42485,50495,3830,21213,39997,61210
American Indian or Alaska Native,9863,0.000497962,218,1.10E-05,4/27/21,0.495310309,1060,97870,42999,51020,3851,21211,40550,61761
Asian,74956,0.000122869,2495,4.09E-06,12/16/20,0.000376836,1975,2293,2293,0,0,2293,0,2293
Asian,76965,0.000126162,2523,4.14E-06,12/17/20,0.001447029,6512,8805,8805,0,0,8805,0,8805
Asian,79185,0.000129801,2545,4.17E-06,12/18/20,0.003105401,10091,18896,18887,9,0,18896,0,18896
Asian,81287,0.000133247,2580,4.23E-06,12/19/20,0.004056282,5786,24682,24667,15,0,24682,0,24682
Asian,83319,0.000136578,2597,4.26E-06,12/20/20,0.004814226,4612,29294,29272,22,0,29292,1,29293
Asian,85081,0.000139466,2601,4.26E-06,12/21/20,0.006558714,10615,39909,39880,29,0,39907,1,39908
Asian,87036,0.000142671,2624,4.30E-06,12/22/20,0.008399669,11202,51111,50652,459,0,51108,1,51109
Asian,87036,0.000142671,2624,4.30E-06,12/23/20,0.010197239,10938,62049,59601,2448,0,62046,1,62047
Asian,90995,0.00014916,2690,4.41E-06,12/24/20,0.011114923,5584,67633,63489,4144,0,67628,2,67630
Asian,92612,0.000151811,2711,4.44E-06,12/25/20,0.011203832,541,68174,63957,4217,0,68169,2,68171
Asian,95039,0.000155789,2745,4.50E-06,12/26/20,0.011775084,3476,71650,66234,5416,0,71643,3,71646
Asian,96779,0.000158642,2758,4.52E-06,12/27/20,0.012114778,2067,73717,67513,6204,0,73710,3,73713
Asian,98692,0.000161777,2770,4.54E-06,12/28/20,0.013570681,8859,82576,73342,9234,0,82567,4,82571
Asian,100569,0.000164854,2818,4.62E-06,12/29/20,0.01518994,9854,92430,78839,13591,0,92420,4,92424
Asian,100569,0.000164854,2818,4.62E-06,12/30/20,0.017099591,11620,104050,85111,18939,0,104038,5,104043
Asian,104690,0.000171609,2949,4.83E-06,12/31/20,0.018148091,6380,110430,87404,23026,0,110414,6,110420
Asian,107465,0.000176158,3003,4.92E-06,1/1/21,0.018271183,749,111179,87699,23480,0,111161,7,111168
Asian,109724,0.000179861,3031,4.97E-06,1/2/21,0.01888352,3726,114905,89357,25548,0,114887,7,114894
Asian,111456,0.0001827,3043,4.99E-06,1/3/21,0.019097658,1303,116208,90051,26157,0,116174,15,116189
Asian,113487,0.00018603,3056,5.01E-06,1/4/21,0.02047517,8382,124590,94340,30250,0,124518,30,124548
Asian,114864,0.000188287,3109,5.10E-06,1/5/21,0.022175121,10344,134934,99856,35078,0,132615,1155,133770
Asian,117227,0.00019216,3171,5.20E-06,1/6/21,0.02461198,14828,149762,108065,41697,0,140356,4677,145033
Asian,120172,0.000196988,3227,5.29E-06,1/7/21,0.027869232,19820,169582,119564,50018,0,145410,12041,157451
Asian,123544,0.000202515,3286,5.39E-06,1/8/21,0.031591079,22647,192229,133563,58666,0,148931,21593,170524
Asian,126414,0.00020722,3349,5.49E-06,1/9/21,0.033360218,10765,202994,139459,63535,0,151663,25609,177272
Asian,128784,0.000211105,3404,5.58E-06,1/10/21,0.034440929,6576,209570,143043,66527,0,152648,28404,181052
Asian,130966,0.000214682,3440,5.64E-06,1/11/21,0.037891283,20995,230565,156108,74457,0,154509,37974,192483
Asian,133241,0.000218411,3535,5.79E-06,1/12/21,0.041645834,22846,253411,168725,84686,0,159165,47072,206237
Asian,135579,0.000222243,3605,5.91E-06,1/13/21,0.045545992,23732,277143,179860,97283,0,168091,54474,222565
Asian,138242,0.000226608,3643,5.97E-06,1/14/21,0.049279835,22720,299863,188114,111749,0,181979,58890,240869
Asian,141013,0.000231151,3718,6.09E-06,1/15/21,0.053591012,26233,326096,197118,128978,0,201236,62380,263616
Asian,143690,0.000235539,3790,6.21E-06,1/16/21,0.056054823,14992,341088,201918,139170,0,212343,64323,276666
Asian,145554,0.000238594,3816,6.26E-06,1/17/21,0.057575476,9253,350341,204694,145647,0,219575,65333,284908
Asian,147086,0.000241106,3827,6.27E-06,1/18/21,0.059996559,14732,365073,211934,153139,0,227109,68937,296046
Asian,148487,0.000243402,3866,6.34E-06,1/19/21,0.063976915,24221,389294,224847,164447,0,239437,74930,314367
Asian,149951,0.000245802,3932,6.45E-06,1/20/21,0.068280038,26184,415478,238389,177089,0,253114,81202,334316
Asian,151576,0.000248466,4005,6.57E-06,1/21/21,0.072936332,28333,443811,249684,194127,0,273331,85266,358597
Asian,152907,0.000250648,4054,6.65E-06,1/22/21,0.077577178,28239,472050,260296,211754,0,295379,88353,383732
Asian,154423,0.000253133,4126,6.76E-06,1/23/21,0.080840676,19858,491908,268120,223788,0,310619,90662,401281
Asian,156230,0.000256095,4155,6.81E-06,1/24/21,0.08270694,11356,503264,273088,230176,0,319850,91723,411573
Asian,157362,0.00025795,4185,6.86E-06,1/25/21,0.086731833,24492,527756,283646,244110,0,330545,98630,429175
Asian,158576,0.00025994,4256,6.98E-06,1/26/21,0.091353122,28120,555876,297036,258840,0,344610,105668,450278
Asian,159865,0.000262053,4341,7.12E-06,1/27/21,0.095924123,27814,583690,309616,274074,0,357991,112872,470863
Asian,161539,0.000264797,4399,7.21E-06,1/28/21,0.100822985,29809,613499,322527,290972,0,374249,119619,493868
Asian,163086,0.000267333,4462,7.31E-06,1/29/21,0.105849705,30587,644086,336111,307975,0,390971,126503,517474
Asian,164484,0.000269625,4532,7.43E-06,1/30/21,0.109117476,19885,663971,343928,320043,0,403883,129981,533864
Asian,165646,0.000271529,4574,7.50E-06,1/31/21,0.110896968,10828,674799,349168,325631,0,412643,131010,543653
Asian,166565,0.000273036,4595,7.53E-06,2/1/21,0.114975107,24815,699614,359109,340505,0,424730,137369,562099
Asian,167317,0.000274269,4643,7.61E-06,2/2/21,0.119709299,28807,728421,369437,358984,0,439426,144411,583837
Asian,168276,0.000275841,4703,7.71E-06,2/3/21,0.125140628,33049,761470,382747,378723,0,454572,153320,607892
Asian,169451,0.000277767,4785,7.84E-06,2/4/21,0.131087991,36189,797659,396366,401293,0,469747,163817,633564
Asian,170401,0.000279324,4850,7.95E-06,2/5/21,0.137735613,40455,838114,412512,425602,0,482408,177682,660090
Asian,171443,0.000281032,4894,8.02E-06,2/6/21,0.142110061,26618,864732,425209,439523,0,495019,184708,679727
Asian,172315,0.000282461,4923,8.07E-06,2/7/21,0.144243216,12980,877712,433985,443727,0,500527,188464,688991
Asian,172934,0.000283476,4938,8.09E-06,2/8/21,0.149404204,31404,909116,448401,460715,0,507749,200539,708288
Asian,173673,0.000284687,5009,8.21E-06,2/9/21,0.155367671,36287,945403,465793,479610,0,510909,217149,728058
Asian,174482,0.000286014,5054,8.28E-06,2/10/21,0.162535107,43614,989017,485852,503165,0,511214,238858,750072
Asian,175198,0.000287187,5110,8.38E-06,2/11/21,0.169044682,39610,1028627,503994,524633,0,512056,258307,770363
Asian,175922,0.000288374,5175,8.48E-06,2/12/21,0.175540124,39524,1068151,520452,547699,0,511232,278593,789825
Asian,176589,0.000289467,5241,8.59E-06,2/13/21,0.179968969,26949,1095100,532684,562416,0,512526,291550,804076
Asian,177100,0.000290305,5271,8.64E-06,2/14/21,0.182784307,17131,1112231,541273,570958,0,513219,299895,813114
Asian,177576,0.000291085,5279,8.65E-06,2/15/21,0.186379282,21875,1134106,550421,583685,0,514613,310272,824885
Asian,177919,0.000291648,5309,8.70E-06,2/16/21,0.192784664,38976,1173082,567156,605926,0,516970,328765,845735
Asian,178375,0.000292395,5371,8.80E-06,2/17/21,0.199198428,39027,1212109,585305,626804,0,516806,348528,865334
Asian,179040,0.000293485,5413,8.87E-06,2/18/21,0.20590357,40800,1252909,606468,646441,0,514315,370325,884640
Asian,179671,0.000294519,5464,8.96E-06,2/19/21,0.212396054,39506,1292415,629998,662417,0,516060,389265,905325
Asian,180258,0.000295482,5504,9.02E-06,2/20/21,0.21635784,24107,1316522,646221,670301,0,519292,399822,919114
Asian,180788,0.00029635,5536,9.07E-06,2/21/21,0.218318272,11929,1328451,655809,672642,0,519245,405880,925125
Asian,181145,0.000296936,5548,9.09E-06,2/22/21,0.222271348,24054,1352505,671713,680792,0,519104,418055,937159
Asian,181664,0.000297786,5590,9.16E-06,2/23/21,0.227951162,34561,1387066,688912,698154,0,515760,437335,953095
Asian,182235,0.000298722,5752,9.43E-06,2/24/21,0.23506305,43276,1430342,710176,720166,0,512734,460971,973705
Asian,182779,0.000299614,5792,9.49E-06,2/25/21,0.242902642,47703,1478045,734255,743790,0,516330,483572,999902
Asian,183305,0.000300476,5848,9.59E-06,2/26/21,0.252086386,55882,1533927,760949,772978,0,521544,509338,1030882
Asian,183711,0.000301142,5875,9.63E-06,2/27/21,0.259297536,43879,1577806,782545,795261,0,524202,530288,1054490
Asian,184102,0.000301783,5903,9.68E-06,2/28/21,0.26332736,24522,1602328,797199,805127,2,527107,541307,1068414
Asian,184371,0.000302224,5910,9.69E-06,3/1/21,0.269545064,37835,1640163,818008,822146,9,531491,558230,1089721
Asian,184765,0.00030287,5958,9.77E-06,3/2/21,0.276865994,44548,1684711,840038,844661,12,538451,577481,1115932
Asian,185183,0.000303555,5997,9.83E-06,3/3/21,0.285380867,51813,1736524,865292,871218,14,545774,600166,1145940
Asian,185631,0.000304289,6041,9.90E-06,3/4/21,0.294328123,54444,1790968,894368,896575,25,555237,623057,1178294
Asian,186096,0.000305051,6073,9.95E-06,3/5/21,0.30294308,52421,1843389,920782,922473,134,568020,643307,1211327
Asian,186562,0.000305815,6105,1.00E-05,3/6/21,0.309992354,42894,1886283,943767,941059,1457,582640,658428,1241068
Asian,186929,0.000306417,6132,1.01E-05,3/7/21,0.313991281,24335,1910618,960305,948247,2066,593114,665936,1259050
Asian,187197,0.000306856,6143,1.01E-05,3/8/21,0.320017527,36669,1947287,979769,963914,3604,611027,676343,1287370
Asian,187815,0.000307869,6209,1.02E-05,3/9/21,0.326916099,41978,1989265,998913,984231,6121,620289,694193,1314482
Asian,188068,0.000308284,6246,1.02E-05,3/10/21,0.334805159,48004,2037269,1023025,1004376,9868,630155,715364,1345519
Asian,188440,0.000308894,6279,1.03E-05,3/11/21,0.344325475,57930,2095199,1054148,1026650,14401,639752,742042,1381794
Asian,188777,0.000309446,6318,1.04E-05,3/12/21,0.354217367,60191,2155390,1083923,1050275,21192,647559,771818,1419377
Asian,189059,0.000309908,6344,1.04E-05,3/13/21,0.361951123,47060,2202450,1105520,1070025,26905,658258,793033,1451291
Asian,189333,0.000310358,6359,1.04E-05,3/14/21,0.367043087,30984,2233434,1123266,1079820,30348,665987,806532,1472519
Asian,189477,0.000310594,6367,1.04E-05,3/15/21,0.374625978,46142,2279576,1147192,1099190,33194,676730,825798,1502528
Asian,189728,0.000311005,6399,1.05E-05,3/16/21,0.384245885,58536,2338112,1176410,1126511,35191,691435,848865,1540300
Asian,190042,0.00031152,6436,1.06E-05,3/17/21,0.393935144,58958,2397070,1205854,1153591,37625,709858,870415,1580273
Asian,190397,0.000312102,6457,1.06E-05,3/18/21,0.403566719,58607,2455677,1236676,1179210,39791,725367,893093,1618460
Asian,190696,0.000312592,6470,1.06E-05,3/19/21,0.413805701,62303,2517980,1271073,1204581,42326,738837,918812,1657649
Asian,190992,0.000313077,6473,1.06E-05,3/20/21,0.421672574,47869,2565849,1297826,1224287,43736,755362,935202,1690564
Asian,191195,0.00031341,6517,1.07E-05,3/21/21,0.425955483,26062,2591911,1315689,1231010,45212,764561,944480,1709041
Asian,191376,0.000313707,6523,1.07E-05,3/22/21,0.433134258,43684,2635595,1342162,1246706,46727,781496,958730,1740226
Asian,191576,0.000314034,6552,1.07E-05,3/23/21,0.442595904,57573,2693168,1375125,1269490,48553,800743,978843,1779586
Asian,191854,0.00031449,6591,1.08E-05,3/24/21,0.452694702,61451,2754619,1412227,1292332,50060,815430,1003005,1818435
Asian,192121,0.000314928,6619,1.09E-05,3/25/21,0.463890975,68128,2822747,1451670,1319009,52068,830084,1030714,1860798
Asian,192468,0.000315497,6648,1.09E-05,3/26/21,0.475199821,68814,2891561,1491175,1346587,53799,842333,1059899,1902232
Asian,192786,0.000316018,6675,1.09E-05,3/27/21,0.484398027,55970,2947531,1522870,1369272,55389,848427,1085642,1934069
Asian,193036,0.000316428,6678,1.09E-05,3/28/21,0.490492311,37084,2984615,1546749,1381901,55965,853503,1101953,1955456
Asian,193189,0.000316678,6678,1.09E-05,3/29/21,0.499356903,53942,3038557,1578385,1402810,57362,861408,1125707,1987115
Asian,193383,0.000316996,6692,1.10E-05,3/30/21,0.51026229,66358,3104915,1614704,1430373,59838,882736,1149485,2032221
Asian,193642,0.000317421,6714,1.10E-05,3/31/21,0.521363737,67551,3172466,1653134,1456715,62617,898187,1176881,2075068
Asian,193920,0.000317877,6749,1.11E-05,4/1/21,0.534748055,81444,3253910,1697861,1486497,69552,917378,1211439,2128817
Asian,194236,0.000318395,6772,1.11E-05,4/2/21,0.547985123,80550,3334460,1739080,1518957,76423,935244,1246209,2181453
Asian,194510,0.000318844,6812,1.12E-05,4/3/21,0.558024101,61087,3395547,1771663,1540275,83609,945403,1275294,2220697
Asian,194775,0.000319278,6844,1.12E-05,4/4/21,0.563374246,32560,3428107,1787942,1551568,88597,947386,1293061,2240447
Asian,194980,0.000319614,6860,1.12E-05,4/5/21,0.573676664,62692,3490799,1822147,1572718,95934,957015,1323384,2280399
Asian,195220,0.000320008,6880,1.13E-05,4/6/21,0.58673427,79460,3570259,1864886,1598869,106504,970054,1361946,2332000
Asian,195480,0.000320434,6894,1.13E-05,4/7/21,0.599939127,80352,3650611,1908996,1623609,118006,984755,1400514,2385269
Asian,195797,0.000320953,6923,1.13E-05,4/8/21,0.613705868,83774,3734385,1953430,1648052,132903,999216,1442667,2441883
Asian,196335,0.000321835,6980,1.14E-05,4/9/21,0.627874589,86227,3820612,1998191,1675102,147319,1013036,1486211,2499247
Asian,196825,0.000322639,7008,1.15E-05,4/10/21,0.638709803,65980,3886592,2030456,1697560,158576,1022163,1520415,2542578
Asian,197098,0.000323086,7029,1.15E-05,4/11/21,0.645335896,40354,3926946,2054708,1706843,165395,1029060,1540801,2569861
Asian,197312,0.000323437,7048,1.16E-05,4/12/21,0.655666416,62859,3989805,2092283,1726917,170605,1040183,1569423,2609606
Asian,197514,0.000323768,7061,1.16E-05,4/13/21,0.668725995,79466,4069271,2142464,1756125,170682,1060761,1599034,2659795
Asian,197722,0.000324109,7092,1.16E-05,4/14/21,0.682161095,81759,4151030,2193848,1786472,170710,1075952,1632671,2708623
Asian,197966,0.000324509,7108,1.17E-05,4/15/21,0.697531647,93541,4244571,2254483,1819348,170740,1102627,1666347,2768974
Asian,198214,0.000324915,7135,1.17E-05,4/16/21,0.71233144,90069,4334640,2310937,1852934,170769,1123237,1701187,2824424
Asian,198481,0.000325353,7145,1.17E-05,4/17/21,0.723140359,65797,4400437,2352682,1876980,170775,1139043,1726479,2865522
Asian,198685,0.000325688,7148,1.17E-05,4/18/21,0.728761503,34206,4434643,2375199,1888669,170775,1144553,1741117,2885670
Asian,198848,0.000325955,7153,1.17E-05,4/19/21,0.738646328,60154,4494797,2413440,1910579,170778,1150096,1768563,2918659
Asian,199042,0.000326273,7164,1.17E-05,4/20/21,0.751035722,75407,4570204,2455530,1943888,170786,1159373,1801938,2961311
Asian,199276,0.000326656,7187,1.18E-05,4/21/21,0.763626269,76624,4646828,2501723,1974277,170828,1167215,1836684,3003899
Asian,199424,0.000326899,7199,1.18E-05,4/22/21,0.776822744,81202,4728030,2551939,2005256,170835,1164320,1879204,3043524
Asian,199608,0.000327201,7206,1.18E-05,4/23/21,0.789853892,79392,4807422,2599661,2036923,170838,1162472,1920708,3083180
Asian,199793,0.000327504,7214,1.18E-05,4/24/21,0.799965673,61581,4869003,2640879,2057271,170853,1163874,1951388,3115262
Asian,199995,0.000327835,7216,1.18E-05,4/25/21,0.805353123,32783,4901786,2663216,2067711,170859,1165912,1966937,3132849
Asian,200145,0.000328081,7217,1.18E-05,4/26/21,0.813055162,46868,4948654,2692326,2085364,170964,1160951,1993475,3154426
Asian,200311,0.000328353,7227,1.18E-05,4/27/21,0.822399468,56888,5005542,2725915,2108107,171520,1149141,2028764,3177905
Black,50060,0.000210618,1534,6.45E-06,12/16/20,0.000145946,294,346,346,0,0,346,0,346
Black,51142,0.000215171,1551,6.53E-06,12/17/20,0.000499424,838,1184,1184,0,0,1184,0,1184
Black,52329,0.000220165,1563,6.58E-06,12/18/20,0.001049042,1303,2487,2486,1,0,2487,0,2487
Black,53554,0.000225319,1577,6.63E-06,12/19/20,0.001351902,718,3205,3204,1,0,3205,0,3205
Black,54750,0.000230351,1584,6.66E-06,12/20/20,0.001585585,554,3759,3757,2,0,3759,0,3759
Black,55921,0.000235278,1593,6.70E-06,12/21/20,0.002227581,1522,5281,5279,2,0,5281,0,5281
Black,56998,0.000239809,1604,6.75E-06,12/22/20,0.002906274,1609,6890,6803,87,0,6890,0,6890
Black,56998,0.000239809,1604,6.75E-06,12/23/20,0.003608166,1664,8554,8185,369,0,8553,0,8553
Black,59207,0.000249103,1637,6.89E-06,12/24/20,0.004047271,1041,9595,8823,772,0,9594,0,9594
Black,59947,0.000252216,1645,6.92E-06,12/25/20,0.004090295,102,9697,8905,792,0,9696,0,9696
Black,61566,0.000259028,1658,6.98E-06,12/26/20,0.004310902,523,10220,9217,1003,0,10219,0,10219
Black,62591,0.00026334,1662,6.99E-06,12/27/20,0.004453052,337,10557,9395,1162,0,10556,0,10556
Black,63619,0.000267665,1668,7.02E-06,12/28/20,0.005252805,1896,12453,10441,2012,0,12452,0,12452
Black,64518,0.000271448,1697,7.14E-06,12/29/20,0.006166024,2165,14618,11499,3119,0,14617,0,14617
Black,64518,0.000271448,1697,7.14E-06,12/30/20,0.007350046,2807,17425,12840,4585,0,17424,0,17424
Black,66557,0.000280027,1759,7.40E-06,12/31/20,0.008035066,1624,19049,13422,5627,0,19046,1,19047
Black,67996,0.000286081,1781,7.49E-06,1/1/21,0.008109727,177,19226,13470,5756,0,19223,1,19224
Black,69353,0.00029179,1801,7.58E-06,1/2/21,0.008377576,635,19861,13750,6111,0,19858,1,19859
Black,70441,0.000296368,1804,7.59E-06,1/3/21,0.008484716,254,20115,13860,6255,0,20112,1,20113
Black,71566,0.000301101,1816,7.64E-06,1/4/21,0.009310199,1957,22072,14791,7281,0,22064,2,22066
Black,72361,0.000304446,1833,7.71E-06,1/5/21,0.010366412,2504,24576,15985,8591,0,24230,172,24402
Black,73573,0.000309545,1853,7.80E-06,1/6/21,0.011647451,3037,27613,17439,10174,0,26283,660,26943
Black,75064,0.000315818,1872,7.88E-06,1/7/21,0.013139816,3538,31151,19210,11941,0,27859,1639,29498
Black,76770,0.000322996,1911,8.04E-06,1/8/21,0.014828323,4003,35154,21431,13723,0,29454,2843,32297
Black,78392,0.00032982,1934,8.14E-06,1/9/21,0.015371615,1288,36442,22172,14270,0,29857,3285,33142
Black,79786,0.000335685,1955,8.23E-06,1/10/21,0.01565001,660,37102,22615,14487,0,29863,3612,33475
Black,81036,0.000340944,1968,8.28E-06,1/11/21,0.017135204,3521,40623,24866,15757,0,30604,5004,35608
Black,82125,0.000345526,2016,8.48E-06,1/12/21,0.018651191,3594,44217,27009,17208,0,31738,6239,37977
Black,83262,0.00035031,2050,8.63E-06,1/13/21,0.020362054,4056,48273,29148,19125,0,33629,7322,40951
Black,84645,0.000356129,2075,8.73E-06,1/14/21,0.022166137,4277,52550,31053,21497,0,36409,8068,44477
Black,86085,0.000362187,2110,8.88E-06,1/15/21,0.024189983,4798,57348,33025,24323,0,40035,8655,48690
Black,87689,0.000368936,2147,9.03E-06,1/16/21,0.025141165,2255,59603,34026,25577,0,41722,8939,50661
Black,88845,0.000373799,2160,9.09E-06,1/17/21,0.025620764,1137,60740,34519,26221,0,42645,9046,51691
Black,89707,0.000377426,2173,9.14E-06,1/18/21,0.026583757,2283,63023,35925,27098,0,43658,9680,53338
Black,90545,0.000380952,2195,9.24E-06,1/19/21,0.028694496,5004,68027,38776,29251,0,46179,10920,57099
Black,91295,0.000384107,2229,9.38E-06,1/20/21,0.030875678,5171,73198,41479,31719,0,48858,12161,61019
Black,92173,0.000387801,2272,9.56E-06,1/21/21,0.033069936,5202,78400,43895,34505,0,52238,13071,65309
Black,92937,0.000391016,2296,9.66E-06,1/22/21,0.035361631,5433,83833,46187,37646,0,56448,13681,70129
Black,93817,0.000394718,2333,9.82E-06,1/23/21,0.036527094,2763,86596,47511,39085,0,58455,14057,72512
Black,94769,0.000398723,2345,9.87E-06,1/24/21,0.037112988,1389,87985,48261,39724,0,59517,14220,73737
Black,95491,0.000401761,2349,9.88E-06,1/25/21,0.039149911,4829,92814,50493,42321,0,61162,15816,76978
Black,96053,0.000404126,2391,1.01E-05,1/26/21,0.041684569,6009,98823,53326,45497,0,63729,17540,81269
Black,96722,0.00040694,2423,1.02E-05,1/27/21,0.044413683,6470,105293,56241,49052,0,66392,19434,85826
Black,97463,0.000410058,2452,1.03E-05,1/28/21,0.04716009,6511,111804,59159,52645,0,69875,20942,90817
Black,98263,0.000413424,2488,1.05E-05,1/29/21,0.05002587,6794,118598,62450,56148,0,73597,22475,96072
Black,98959,0.000416352,2516,1.06E-05,1/30/21,0.051560838,3639,122237,63956,58281,0,76120,23027,99147
Black,99580,0.000418965,2532,1.07E-05,1/31/21,0.052368183,1914,124151,64978,59173,0,77663,23213,100876
Black,100076,0.000421052,2539,1.07E-05,2/1/21,0.054988048,6211,130362,67667,62695,0,80571,24857,105428
Black,100486,0.000422777,2571,1.08E-05,2/2/21,0.058091307,7357,137719,70436,67283,0,84222,26705,110927
Black,101004,0.000424956,2601,1.09E-05,2/3/21,0.061693568,8540,146259,73450,72809,0,88052,29055,117107
Black,101616,0.000427531,2632,1.11E-05,2/4/21,0.065558616,9163,155422,76918,78504,0,92588,31365,123953
Black,102113,0.000429622,2662,1.12E-05,2/5/21,0.069753099,9944,165366,80686,84680,0,96754,34247,131001
Black,102703,0.000432104,2677,1.13E-05,2/6/21,0.07220677,5817,171183,83057,88126,0,100523,35270,135793
Black,103111,0.000433821,2699,1.14E-05,2/7/21,0.073055031,2011,173194,84305,88889,0,101721,35678,137399
Black,103481,0.000435378,2713,1.14E-05,2/8/21,0.075943167,6847,180041,87456,92585,0,104460,37733,142193
Black,103870,0.000437014,2749,1.16E-05,2/9/21,0.079419306,8241,188282,91485,96797,0,106891,40647,147538
Black,104332,0.000438958,2783,1.17E-05,2/10/21,0.083313038,9232,197514,95656,101858,0,109083,44179,153262
Black,104756,0.000440742,2810,1.18E-05,2/11/21,0.0874143,9723,207237,100210,107027,0,111826,47674,159500
Black,105179,0.000442522,2828,1.19E-05,2/12/21,0.091999801,10871,218108,104901,113207,0,114588,51747,166335
Black,105625,0.000444398,2857,1.20E-05,2/13/21,0.094437865,5781,223889,107565,116324,0,116840,53525,170365
Black,105960,0.000445808,2863,1.20E-05,2/14/21,0.095598266,2751,226640,109163,117477,0,117614,54520,172134
Black,106201,0.000446822,2865,1.21E-05,2/15/21,0.097717441,5024,231664,111501,120163,0,119243,56233,175476
Black,106400,0.000447659,2876,1.21E-05,2/16/21,0.101823344,9734,241398,116247,125151,0,121627,59932,181559
Black,106708,0.000448955,2891,1.22E-05,2/17/21,0.105938104,9755,251153,121474,129679,0,123556,63860,187416
Black,107081,0.000450524,2918,1.23E-05,2/18/21,0.110178142,10052,261205,127336,133869,0,125178,68090,193268
Black,107436,0.000452018,2946,1.24E-05,2/19/21,0.114605464,10496,271701,133489,138212,0,127165,72355,199520
Black,107741,0.000453301,2972,1.25E-05,2/20/21,0.116760072,5108,276809,136753,140056,0,128499,74257,202756
Black,108013,0.000454445,2982,1.25E-05,2/21/21,0.11787787,2650,279459,138951,140508,0,129656,75017,204673
Black,108204,0.000455249,2984,1.26E-05,2/22/21,0.120513763,6249,285708,143304,142404,0,130582,77687,208269
Black,108479,0.000456406,3004,1.26E-05,2/23/21,0.12401268,8295,294003,147911,146092,0,131565,81404,212969
Black,108739,0.0004575,3089,1.30E-05,2/24/21,0.128201679,9931,303934,153307,150627,0,132369,86031,218400
Black,109065,0.000458871,3119,1.31E-05,2/25/21,0.133201398,11853,315787,159677,156110,0,134578,90916,225494
Black,109352,0.000460079,3142,1.32E-05,2/26/21,0.138681559,12992,328779,165954,162825,0,137438,96057,233495
Black,109591,0.000461084,3161,1.33E-05,2/27/21,0.142606926,9307,338086,170954,167130,2,140184,99371,239555
Black,109810,0.000462006,3179,1.34E-05,2/28/21,0.144730742,5035,343121,174252,168867,2,142412,100800,243212
Black,109920,0.000462469,3188,1.34E-05,3/1/21,0.148670451,9341,352462,179149,173305,8,144510,104463,248973
Black,110115,0.000463289,3209,1.35E-05,3/2/21,0.153763811,12077,364539,185078,179451,10,146434,109609,256043
Black,110397,0.000464475,3222,1.36E-05,3/3/21,0.159470906,13530,378069,191709,186349,11,148212,115561,263773
Black,110700,0.00046575,3237,1.36E-05,3/4/21,0.165411684,14084,392153,198410,193728,15,150217,121684,271901
Black,110994,0.000466987,3262,1.37E-05,3/5/21,0.171216217,13762,405915,205025,200852,38,154032,126741,280773
Black,111279,0.000468186,3275,1.38E-05,3/6/21,0.175549897,10274,416189,210187,205677,325,156258,130964,287222
Black,111452,0.000468914,3279,1.38E-05,3/7/21,0.177846233,5444,421633,213555,207652,426,157909,132954,290863
Black,111621,0.000469625,3278,1.38E-05,3/8/21,0.181523576,8718,430351,217510,212157,684,161038,135928,296966
Black,111916,0.000470866,3309,1.39E-05,3/9/21,0.186351617,11446,441797,222750,217839,1208,161994,141492,303486
Black,112115,0.000471704,3329,1.40E-05,3/10/21,0.19174826,12795,454592,228834,223779,1979,164215,147219,311434
Black,112357,0.000472722,3349,1.41E-05,3/11/21,0.198499335,16006,470598,236467,230761,3370,165565,155298,320863
Black,112580,0.00047366,3360,1.41E-05,3/12/21,0.205854443,17437,488035,243611,238652,5772,167132,164487,331619
Black,112784,0.000474518,3373,1.42E-05,3/13/21,0.210400716,10779,498814,247934,243889,6991,168912,169640,338552
Black,112973,0.000475314,3373,1.42E-05,3/14/21,0.213217144,6677,505491,251438,246132,7921,170267,172789,343056
Black,113064,0.000475696,3374,1.42E-05,3/15/21,0.218178056,11761,517252,256792,251320,9140,172280,178299,350579
Black,113234,0.000476412,3392,1.43E-05,3/16/21,0.224849831,15817,533069,263894,258972,10203,174782,185525,360307
Black,113471,0.000477409,3413,1.44E-05,3/17/21,0.231585721,15969,549038,271376,266336,11326,178687,192142,370829
Black,113683,0.000478301,3422,1.44E-05,3/18/21,0.238632486,16706,565744,279450,273796,12498,181955,199463,381418
Black,113876,0.000479113,3437,1.45E-05,3/19/21,0.245999405,17465,583209,287748,281314,14147,184826,207610,392436
Black,114079,0.000479967,3438,1.45E-05,3/20/21,0.2513758,12746,595955,294300,286379,15276,187812,213076,400888
Black,114202,0.000480484,3459,1.46E-05,3/21/21,0.254063154,6371,602326,298219,288421,15686,189321,215745,405066
Black,114318,0.000480972,3461,1.46E-05,3/22/21,0.258878542,11416,613742,304324,292835,16583,192854,220165,413019
Black,114463,0.000481582,3471,1.46E-05,3/23/21,0.265287529,15196,628938,312224,299250,17464,196802,226261,423063
Black,114642,0.000482336,3487,1.47E-05,3/24/21,0.271782565,15398,644336,320401,305588,18347,199731,232960,432691
Black,114803,0.000483013,3509,1.48E-05,3/25/21,0.278684227,16362,660698,328674,312551,19473,203047,240074,443121
Black,115054,0.000484069,3520,1.48E-05,3/26/21,0.285728039,16700,677398,337193,319819,20386,204769,248051,452820
Black,115294,0.000485079,3538,1.49E-05,3/27/21,0.290680093,11740,689138,343154,324973,21011,205066,254097,459163
Black,115469,0.000485815,3538,1.49E-05,3/28/21,0.293383898,6410,695548,347081,327279,21188,205041,257429,462470
Black,115637,0.000486522,3539,1.49E-05,3/29/21,0.298570479,12297,707845,353005,333084,21756,207024,262895,469919
Black,115773,0.000487094,3544,1.49E-05,3/30/21,0.30517392,15655,723500,360489,339906,23105,210349,269746,480095
Black,115949,0.000487835,3554,1.50E-05,3/31/21,0.312060397,16328,739828,368824,346738,24266,212930,277211,490141
Black,116153,0.000488693,3569,1.50E-05,4/1/21,0.319508725,17658,757486,377028,354256,26202,215197,285880,501077
Black,116474,0.000490043,3583,1.51E-05,4/2/21,0.327199172,18232,775718,384958,362230,28530,217330,295104,512434
Black,116648,0.000490775,3591,1.51E-05,4/3/21,0.332080784,11573,787291,389986,366595,30710,218801,301262,520063
Black,116831,0.000491545,3599,1.51E-05,4/4/21,0.334250155,5144,792435,392290,368448,31697,218470,304491,522961
Black,116979,0.000492168,3603,1.52E-05,4/5/21,0.339864873,13313,805748,398270,374011,33467,219219,311671,530890
Black,117180,0.000493014,3611,1.52E-05,4/6/21,0.347172739,17325,823073,406171,380377,36525,220266,321352,541618
Black,117337,0.000493674,3628,1.53E-05,4/7/21,0.354960202,18463,841536,414810,386816,39910,222126,331364,553490
Black,117558,0.000494604,3640,1.53E-05,4/8/21,0.36315176,19420,860956,423718,393422,43816,223901,342157,566058
Black,117905,0.000496064,3665,1.54E-05,4/9/21,0.370978874,18556,879512,431715,400723,47074,224402,352855,577257
Black,118240,0.000497474,3673,1.55E-05,4/10/21,0.376281453,12579,892091,436555,405665,49871,224376,360584,584960
Black,118454,0.000498374,3677,1.55E-05,4/11/21,0.378927469,6273,898364,439525,407925,50914,224135,364410,588545
Black,118607,0.000499018,3685,1.55E-05,4/12/21,0.384187867,12471,910835,445157,413361,52317,224415,371248,595663
Black,118815,0.000499893,3693,1.55E-05,4/13/21,0.390881154,15868,926703,453417,420929,52357,225616,378649,604265
Black,118986,0.000500612,3702,1.56E-05,4/14/21,0.397694236,16155,942858,461356,429132,52370,225928,386664,612592
Black,119188,0.000501462,3713,1.56E-05,4/15/21,0.404714005,16643,959501,470003,437121,52377,225782,395111,620893
Black,119452,0.000502573,3722,1.57E-05,4/16/21,0.411404761,15868,975369,478033,444952,52384,225303,403307,628610
Black,119717,0.000503688,3730,1.57E-05,4/17/21,0.416222258,11460,986829,484084,450361,52384,225775,408852,634627
Black,119930,0.000504584,3731,1.57E-05,4/18/21,0.418491598,5380,992209,486724,453097,52388,225490,411749,637239
Black,120097,0.000505286,3732,1.57E-05,4/19/21,0.42343395,11718,1003927,492659,458880,52388,223928,418414,642342
Black,120292,0.000506107,3738,1.57E-05,4/20/21,0.429594913,14610,1018537,500041,466108,52388,223062,426222,649284
Black,120487,0.000506927,3745,1.58E-05,4/21/21,0.435950752,15069,1033606,507761,473445,52400,221920,434387,656307
Black,120656,0.000507638,3752,1.58E-05,4/22/21,0.442503998,15698,1049304,516026,480876,52402,220558,442975,663533
Black,120883,0.000508593,3755,1.58E-05,4/23/21,0.448938716,15285,1064589,524392,487793,52404,219618,451183,670801
Black,121090,0.000509464,3762,1.58E-05,4/24/21,0.453567664,10978,1075567,530869,492290,52408,220434,456344,676778
Black,121275,0.000510243,3762,1.58E-05,4/25/21,0.455760234,5198,1080765,533971,494385,52409,221057,458660,679717
Black,121467,0.000511051,3764,1.58E-05,4/26/21,0.460225941,10591,1091356,539739,499139,52478,220614,464306,684920
Black,121633,0.000511749,3771,1.59E-05,4/27/21,0.46557534,12696,1104052,546523,504841,52688,219394,471470,690864
Latino,704045,0.000456886,10309,6.69E-06,12/16/20,8.18E-05,1129,1257,1257,0,0,1257,0,1257
Latino,718812,0.000466469,10454,6.78E-06,12/17/20,0.000354386,4190,5447,5447,0,0,5447,0,5447
Latino,733236,0.000475829,10563,6.85E-06,12/18/20,0.000772271,6423,11870,11863,7,0,11870,0,11870
Latino,749406,0.000486322,10631,6.90E-06,12/19/20,0.00100213,3533,15403,15391,12,0,15403,0,15403
Latino,762170,0.000494606,10680,6.93E-06,12/20/20,0.001167905,2548,17951,17939,12,0,17951,0,17951
Latino,776907,0.000504169,10721,6.96E-06,12/21/20,0.001658919,7547,25498,25478,20,0,25498,0,25498
Latino,789553,0.000512376,10887,7.07E-06,12/22/20,0.002147655,7512,33010,32611,399,0,33010,0,33010
Latino,789553,0.000512376,10887,7.07E-06,12/23/20,0.002643352,7619,40629,38824,1805,0,40629,0,40629
Latino,818803,0.000531357,11132,7.22E-06,12/24/20,0.002874708,3556,44185,41104,3081,0,44185,0,44185
Latino,829409,0.00053824,11194,7.26E-06,12/25/20,0.002895203,315,44500,41353,3147,0,44500,0,44500
Latino,850387,0.000551853,11274,7.32E-06,12/26/20,0.003021941,1948,46448,42614,3834,0,46448,0,46448
Latino,863013,0.000560047,11325,7.35E-06,12/27/20,0.003117775,1473,47921,43421,4500,0,47919,1,47920
Latino,875282,0.000568009,11381,7.39E-06,12/28/20,0.00358374,7162,55083,47647,7436,0,55081,1,55082
Latino,887580,0.00057599,11575,7.51E-06,12/29/20,0.004175988,9102,64185,52122,12063,0,64181,2,64183
Latino,887580,0.00057599,11575,7.51E-06,12/30/20,0.00487975,10817,75002,57270,17732,0,74996,2,74998
Latino,916049,0.000594464,12009,7.79E-06,12/31/20,0.005282671,6193,81195,59118,22077,0,81181,6,81187
Latino,934959,0.000606736,12181,7.90E-06,1/1/21,0.005331597,752,81947,59346,22601,0,81933,6,81939
Latino,951899,0.000617729,12282,7.97E-06,1/2/21,0.005507911,2710,84657,60303,24354,0,84643,6,84649
Latino,966661,0.000627309,12314,7.99E-06,1/3/21,0.005572321,990,85647,60703,24944,0,85629,8,85637
Latino,979315,0.000635521,12422,8.06E-06,1/4/21,0.00606854,7627,93274,63819,29455,0,93236,13,93249
Latino,990854,0.000643009,12583,8.17E-06,1/5/21,0.00678128,10955,104229,68298,35931,0,102737,740,103477
Latino,1007959,0.000654109,12827,8.32E-06,1/6/21,0.007690699,13978,118207,74483,43724,0,112559,2802,115361
Latino,1031277,0.000669241,13040,8.46E-06,1/7/21,0.008806165,17146,135353,82556,52797,0,120709,7293,128002
Latino,1054317,0.000684193,13300,8.63E-06,1/8/21,0.010110633,20050,155403,92348,63055,0,128663,13337,142000
Latino,1078116,0.000699637,13484,8.75E-06,1/9/21,0.010558185,6879,162282,95953,66329,0,131040,15587,146627
Latino,1098158,0.000712643,13627,8.84E-06,1/10/21,0.010799105,3703,165985,97893,68092,0,131759,17079,148838
Latino,1116243,0.000724379,13708,8.90E-06,1/11/21,0.011844826,16073,182058,107195,74863,0,135210,23398,158608
Latino,1133397,0.000735511,14078,9.14E-06,1/12/21,0.013011561,17933,199991,116159,83832,0,141471,29248,170719
Latino,1148799,0.000745506,14292,9.27E-06,1/13/21,0.01424329,18932,218923,124771,94152,0,150402,34244,184646
Latino,1169350,0.000758843,14443,9.37E-06,1/14/21,0.015557647,20202,239125,131219,107906,0,165293,36900,202193
Latino,1187089,0.000770354,14649,9.51E-06,1/15/21,0.017142527,24360,263485,138668,124817,0,185402,39022,224424
Latino,1206977,0.00078326,14886,9.66E-06,1/16/21,0.017795346,10034,273519,142068,131451,0,193268,40106,233374
Latino,1222272,0.000793186,15018,9.75E-06,1/17/21,0.018129238,5132,278651,143538,135113,0,197420,40599,238019
Latino,1234755,0.000801287,15119,9.81E-06,1/18/21,0.018956029,12708,291359,149683,141676,0,204621,43357,247978
Latino,1245900,0.000808519,15240,9.89E-06,1/19/21,0.02034911,21411,312770,160888,151882,0,216246,48268,264514
Latino,1255339,0.000814645,15554,1.01E-05,1/20/21,0.021963657,24816,337586,173644,163942,0,231048,53288,284336
Latino,1267145,0.000822306,15829,1.03E-05,1/21/21,0.023829599,28680,366266,187138,179128,0,254276,56010,310286
Latino,1277389,0.000828954,16046,1.04E-05,1/22/21,0.025712716,28944,395210,198646,196564,0,278406,58410,336816
Latino,1289848,0.000837039,16348,1.06E-05,1/23/21,0.026791944,16588,411798,206767,205031,0,292311,59749,352060
Latino,1301553,0.000844635,16433,1.07E-05,1/24/21,0.027321473,8139,419937,211568,208369,0,299263,60341,359604
Latino,1309764,0.000849963,16518,1.07E-05,1/25/21,0.028712536,21381,441318,220755,220563,0,309699,65829,375528
Latino,1317261,0.000854829,16822,1.09E-05,1/26/21,0.030403595,25992,467310,233078,234232,0,322710,72319,395029
Latino,1326727,0.000860971,17147,1.11E-05,1/27/21,0.032249108,28366,495676,246692,248984,0,336633,79526,416159
Latino,1336890,0.000867567,17404,1.13E-05,1/28/21,0.034244325,30668,526344,260747,265597,0,354862,85735,440597
Latino,1347343,0.00087435,17681,1.15E-05,1/29/21,0.03626368,31038,557382,276238,281144,0,373533,91861,465394
Latino,1355776,0.000879823,17965,1.17E-05,1/30/21,0.037418963,17757,575139,284073,291066,0,386339,94324,480663
Latino,1364160,0.000885263,18123,1.18E-05,1/31/21,0.037931252,7874,583013,288116,294897,0,392959,94948,487907
Latino,1370089,0.000889111,18220,1.18E-05,2/1/21,0.039511772,24293,607306,297905,309401,0,404948,101092,506040
Latino,1375197,0.000892426,18502,1.20E-05,2/2/21,0.041491895,30435,637741,307972,329769,0,420448,108540,528988
Latino,1382352,0.000897069,18756,1.22E-05,2/3/21,0.043704285,34005,671746,320824,350922,0,436310,117583,553893
Latino,1389409,0.000901649,19117,1.24E-05,2/4/21,0.04622142,38690,710436,335356,375080,0,453456,128337,581793
Latino,1395863,0.000905837,19407,1.26E-05,2/5/21,0.049052798,43522,753958,351754,402204,0,467372,143102,610474
Latino,1402958,0.000910441,19624,1.27E-05,2/6/21,0.050585108,23552,777510,362816,414694,0,481385,147877,629262
Latino,1407969,0.000913693,19756,1.28E-05,2/7/21,0.051157057,8791,786301,367842,418459,0,486762,149605,636367
Latino,1411997,0.000916307,19846,1.29E-05,2/8/21,0.053031977,28818,815119,380977,434142,0,498567,158157,656724
Latino,1415893,0.000918835,20125,1.31E-05,2/9/21,0.055335843,35411,850530,397161,453369,0,507075,171674,678749
Latino,1421616,0.000922549,20364,1.32E-05,2/10/21,0.058070996,42040,892570,416428,476142,0,515614,188475,704089
Latino,1427192,0.000926168,20596,1.34E-05,2/11/21,0.06153522,53246,945816,441085,504731,0,524248,210912,735160
Latino,1432099,0.000929352,20782,1.35E-05,2/12/21,0.065084478,54553,1000369,462923,537446,0,532905,234021,766926
Latino,1437235,0.000932685,20989,1.36E-05,2/13/21,0.066936041,28459,1028828,476374,552454,0,538245,245695,783940
Latino,1441312,0.000935331,21098,1.37E-05,2/14/21,0.067928347,15252,1044080,483457,560623,0,541878,251701,793579
Latino,1444316,0.00093728,21139,1.37E-05,2/15/21,0.069542504,24810,1068890,493182,575708,0,550032,260437,810469
Latino,1446427,0.00093865,21267,1.38E-05,2/16/21,0.072401272,43940,1112830,514352,598478,0,560638,277376,838014
Latino,1449831,0.000940859,21466,1.39E-05,2/17/21,0.075353338,45374,1158204,538150,620054,0,568363,296498,864861
Latino,1454195,0.000943691,21677,1.41E-05,2/18/21,0.078617435,50170,1208374,564348,644026,0,574434,319458,893892
Latino,1458771,0.000946661,21866,1.42E-05,2/19/21,0.081951016,51239,1259613,592248,667365,0,581466,341682,923148
Latino,1462751,0.000949243,22030,1.43E-05,2/20/21,0.083811493,28596,1288209,611094,677115,0,589266,352231,941497
Latino,1466824,0.000951887,22114,1.44E-05,2/21/21,0.084500161,10585,1298794,620344,678450,0,592960,355810,948770
Latino,1469005,0.000953302,22141,1.44E-05,2/22/21,0.086435132,29741,1328535,640482,688053,0,599220,367740,966960
Latino,1472040,0.000955271,22371,1.45E-05,2/23/21,0.089016872,39682,1368217,661833,706384,0,607057,384312,991369
Latino,1476643,0.000958259,22893,1.49E-05,2/24/21,0.092349933,51230,1419447,688631,730816,0,617585,405563,1023148
Latino,1479012,0.000959796,23046,1.50E-05,2/25/21,0.096402241,62287,1481734,719415,762319,0,636976,428003,1064979
Latino,1484054,0.000963068,23307,1.51E-05,2/26/21,0.101289993,75126,1556860,755930,800930,0,665719,451943,1117662
Latino,1487225,0.000965126,23435,1.52E-05,2/27/21,0.104530798,49812,1606672,780825,825843,4,686022,467136,1153158
Latino,1490539,0.000967276,23571,1.53E-05,2/28/21,0.106124461,24495,1631167,796161,835001,5,698156,473705,1171861
Latino,1492186,0.000968345,23608,1.53E-05,3/1/21,0.109501959,51915,1683082,821807,861256,19,717730,490361,1208091
Latino,1494376,0.000969766,23768,1.54E-05,3/2/21,0.113399682,59909,1742991,848781,894189,21,742998,508547,1251545
Latino,1498006,0.000972122,23976,1.56E-05,3/3/21,0.118081517,71961,1814952,882958,931965,29,771890,531043,1302933
Latino,1501574,0.000974437,24150,1.57E-05,3/4/21,0.123235758,79222,1894174,922139,971990,45,804687,555103,1359790
Latino,1505360,0.000976894,24282,1.58E-05,3/5/21,0.128510232,81072,1975246,962472,1012633,141,843347,577205,1420552
Latino,1509103,0.000979323,24402,1.58E-05,3/6/21,0.132497544,61287,2036533,994591,1040157,1785,876329,592871,1469200
Latino,1511539,0.000980904,24429,1.59E-05,3/7/21,0.134070452,24176,2060709,1010254,1047857,2598,890331,598916,1489247
Latino,1513632,0.000982262,24441,1.59E-05,3/8/21,0.13731425,49858,2110567,1035666,1070165,4736,915651,612943,1528594
Latino,1517144,0.000984541,24687,1.60E-05,3/9/21,0.141266104,60741,2171308,1064280,1098705,8323,934993,636135,1571128
Latino,1519953,0.000986364,24810,1.61E-05,3/10/21,0.146206881,75941,2247249,1102585,1130084,14580,959218,665772,1624990
Latino,1523141,0.000988433,24975,1.62E-05,3/11/21,0.152037753,89622,2336871,1145346,1167802,23723,984093,703428,1687521
Latino,1525777,0.000990144,25078,1.63E-05,3/12/21,0.158405898,97881,2434752,1189265,1208825,36662,1009778,746518,1756296
Latino,1528371,0.000991827,25161,1.63E-05,3/13/21,0.163190854,73547,2508299,1222398,1239088,46813,1037089,775331,1812420
Latino,1530227,0.000993032,25222,1.64E-05,3/14/21,0.165385808,33737,2542036,1240534,1250336,51166,1046927,789810,1836737
Latino,1531667,0.000993966,25236,1.64E-05,3/15/21,0.169996467,70867,2612903,1272601,1282446,57856,1069806,817597,1887403
Latino,1533493,0.000995151,25357,1.65E-05,3/16/21,0.175923825,91107,2704010,1314252,1326895,62863,1104162,849067,1953229
Latino,1536241,0.000996934,25517,1.66E-05,3/17/21,0.18240049,99548,2803558,1362668,1372401,68489,1148414,879885,2028299
Latino,1538923,0.000998675,25623,1.66E-05,3/18/21,0.189114562,103197,2906755,1414144,1419358,73253,1186795,914988,2101783
Latino,1541274,0.0010002,25667,1.67E-05,3/19/21,0.19638126,111692,3018447,1471433,1468140,78874,1222151,956143,2178294
Latino,1543403,0.001001582,25678,1.67E-05,3/20/21,0.201742134,82399,3100846,1512705,1503974,84167,1260616,980919,2241535
Latino,1545009,0.001002624,25843,1.68E-05,3/21/21,0.204013405,34911,3135757,1537661,1511918,86178,1274136,993007,2267143
Latino,1545951,0.001003236,25854,1.68E-05,3/22/21,0.208546316,69674,3205431,1578311,1538493,88627,1306617,1013316,2319933
Latino,1546872,0.001003833,25967,1.69E-05,3/23/21,0.214693058,94479,3299910,1628213,1580309,91388,1347589,1041830,2389419
Latino,1548843,0.001005112,26078,1.69E-05,3/24/21,0.221424697,103468,3403378,1683956,1623866,95556,1383764,1078142,2461906
Latino,1551306,0.001006711,26219,1.70E-05,3/25/21,0.228723925,112192,3515570,1742609,1672421,100540,1416655,1120563,2537218
Latino,1553962,0.001008434,26351,1.71E-05,3/26/21,0.237083839,128498,3644068,1807492,1730437,106139,1448272,1172300,2620572
Latino,1556231,0.001009907,26429,1.72E-05,3/27/21,0.242927203,89815,3733883,1853950,1770065,109868,1464979,1211125,2676104
Latino,1558356,0.001011286,26449,1.72E-05,3/28/21,0.245657997,41985,3775868,1881205,1783591,111072,1473140,1228958,2702098
Latino,1560087,0.001012409,26460,1.72E-05,3/29/21,0.251156995,84522,3860390,1926846,1820014,113530,1493603,1262586,2756189
Latino,1561359,0.001013234,26530,1.72E-05,3/30/21,0.258623495,114762,3975152,1984701,1870785,119666,1529196,1305495,2834691
Latino,1563114,0.001014373,26613,1.73E-05,3/31/21,0.266704623,124212,4099364,2051398,1921954,126012,1561938,1354465,2916403
Latino,1565720,0.001016065,26682,1.73E-05,4/1/21,0.275269088,131638,4231002,2118103,1977539,135360,1588458,1411774,3000232
Latino,1567947,0.00101751,26780,1.74E-05,4/2/21,0.283811887,131309,4362311,2181278,2035707,145326,1616170,1468628,3084798
Latino,1570215,0.001018982,26806,1.74E-05,4/3/21,0.290089271,96486,4458797,2229377,2073070,156350,1631605,1514880,3146485
Latino,1572022,0.001020154,26833,1.74E-05,4/4/21,0.292161846,31874,4490671,2246625,2083451,160595,1634580,1531458,3166038
Latino,1573813,0.001021316,26850,1.74E-05,4/5/21,0.298097532,91234,4581905,2294498,2117705,169702,1646639,1576057,3222696
Latino,1575330,0.001022301,26918,1.75E-05,4/6/21,0.306150619,123780,4705685,2358271,2159565,187849,1667714,1636751,3304465
Latino,1577681,0.001023827,26968,1.75E-05,4/7/21,0.314661018,130809,4836494,2424548,2204126,207820,1687678,1702511,3390189
Latino,1579840,0.001025228,27042,1.75E-05,4/8/21,0.323513376,136064,4972558,2493963,2247682,230913,1710619,1770803,3481422
Latino,1582594,0.001027015,27138,1.76E-05,4/9/21,0.332456233,137457,5110015,2561981,2293746,254288,1731351,1841247,3572598
Latino,1586084,0.00102928,27194,1.76E-05,4/10/21,0.340186814,118955,5228970,2617862,2327756,283352,1743894,1909261,3653155
Latino,1587592,0.001030258,27227,1.77E-05,4/11/21,0.343558652,51867,5280837,2647479,2338494,294864,1747573,1939430,3687003
Latino,1588988,0.001031164,27239,1.77E-05,4/12/21,0.349672539,93972,5374809,2695291,2374267,305251,1752510,1989541,3742051
Latino,1590125,0.001031902,27381,1.78E-05,4/13/21,0.357877803,126118,5500927,2765622,2429807,305498,1773030,2042936,3815966
Latino,1591357,0.001032701,27452,1.78E-05,4/14/21,0.366491063,132500,5633427,2839215,2488658,305554,1785532,2103703,3889235
Latino,1592932,0.001033724,27497,1.78E-05,4/15/21,0.375320975,135763,5769190,2916147,2547420,305623,1805216,2162400,3967616
Latino,1595297,0.001035258,27539,1.79E-05,4/16/21,0.384458625,140570,5909760,2993678,2610357,305725,1814446,2228479,4042925
Latino,1597381,0.001036611,27569,1.79E-05,4/17/21,0.39155688,109672,6019432,3053912,2659789,305731,1834827,2273523,4108350
Latino,1599172,0.001037773,27565,1.79E-05,4/18/21,0.394257616,41512,6060944,3082715,2672493,305736,1839666,2292389,4132055
Latino,1600240,0.001038466,27573,1.79E-05,4/19/21,0.399943729,87428,6148372,3133307,2709307,305758,1837480,2337581,4175061
Latino,1601596,0.001039346,27616,1.79E-05,4/20/21,0.407962985,123305,6271677,3199640,2766265,305772,1839250,2399121,4238371
Latino,1603628,0.001040665,27643,1.79E-05,4/21/21,0.416503051,131494,6403171,3272214,2825109,305848,1839192,2465755,4304947
Latino,1605058,0.001041593,27696,1.80E-05,4/22/21,0.425217481,135374,6538545,3345768,2886918,305859,1834951,2536532,4371483
Latino,1606081,0.001042257,27714,1.80E-05,4/23/21,0.434148757,137519,6676064,3420309,2949867,305888,1833686,2607050,4440736
Latino,1607394,0.001043109,27736,1.80E-05,4/24/21,0.441508492,113156,6789220,3490373,2992938,305909,1853226,2654695,4507921
Latino,1609135,0.001044238,27738,1.80E-05,4/25/21,0.444476303,45616,6834836,3520872,3008040,305924,1863670,2672654,4536324
Latino,1610105,0.001044868,27739,1.80E-05,4/26/21,0.449676086,79932,6914768,3568256,3040320,306192,1862872,2714357,4577229
Latino,1611216,0.001045589,27807,1.80E-05,4/27/21,0.456538237,105610,7020378,3627313,3085612,307453,1855103,2772864,4627967
White,244082,0.000168349,6643,4.58E-06,12/16/20,0.000241884,3016,3498,3498,0,0,3498,0,3498
White,249993,0.000172426,6782,4.68E-06,12/17/20,0.000878057,9200,12698,12698,0,0,12698,0,12698
White,256610,0.00017699,6873,4.74E-06,12/18/20,0.001958791,15629,28327,28304,23,0,28327,0,28327
White,263503,0.000181744,6942,4.79E-06,12/19/20,0.002536948,8361,36688,36657,31,0,36688,0,36688
White,270068,0.000186273,7001,4.83E-06,12/20/20,0.002961801,6144,42832,42789,43,0,42832,0,42832
White,275360,0.000189923,7041,4.86E-06,12/21/20,0.004128003,16865,59697,59610,87,0,59694,1,59695
White,281095,0.000193878,7133,4.92E-06,12/22/20,0.005320412,17244,76941,76039,902,0,76938,1,76939
White,281095,0.000193878,7133,4.92E-06,12/23/20,0.006516694,17300,94241,89958,4283,0,94236,1,94237
White,292850,0.000201986,7351,5.07E-06,12/24/20,0.007061798,7883,102124,95241,6883,0,102118,1,102119
White,298104,0.00020561,7413,5.11E-06,12/25/20,0.007108473,675,102799,95817,6982,0,102793,1,102794
White,304451,0.000209987,7482,5.16E-06,12/26/20,0.007474273,5290,108089,99103,8986,0,108083,1,108084
White,309333,0.000213355,7497,5.17E-06,12/27/20,0.007712838,3450,111539,101168,10371,0,111533,1,111534
White,314179,0.000216697,7525,5.19E-06,12/28/20,0.008843082,16345,127884,111046,16838,0,127874,3,127877
White,319136,0.000220116,7679,5.30E-06,12/29/20,0.010070965,17757,145641,120634,25007,0,145629,4,145633
White,319136,0.000220116,7679,5.30E-06,12/30/20,0.01150844,20788,166429,131695,34734,0,166417,4,166421
White,330626,0.000228041,8008,5.52E-06,12/31/20,0.012202214,10033,176462,135590,40872,0,176448,4,176452
White,338842,0.000233708,8136,5.61E-06,1/1/21,0.012310087,1560,178022,136283,41739,0,178004,6,178010
White,345442,0.00023826,8211,5.66E-06,1/2/21,0.012709286,5773,183795,139225,44570,0,183777,6,183783
White,350048,0.000241437,8230,5.68E-06,1/3/21,0.012850696,2045,185840,140367,45473,0,185817,6,185823
White,355808,0.00024541,8309,5.73E-06,1/4/21,0.013865876,14681,200521,146939,53582,0,200454,23,200477
White,360022,0.000248316,8441,5.82E-06,1/5/21,0.015176946,18960,219481,156301,63180,0,215459,2014,217473
White,366351,0.000252681,8619,5.94E-06,1/6/21,0.016875735,24567,244048,169522,74526,0,228783,7616,236399
White,374526,0.00025832,8791,6.06E-06,1/7/21,0.019045846,31383,275431,186313,89118,0,239071,18153,257224
White,383641,0.000264607,8976,6.19E-06,1/8/21,0.021556793,36312,311743,208051,103692,0,245636,33009,278645
White,391396,0.000269955,9133,6.30E-06,1/9/21,0.022573149,14698,326441,215839,110602,0,249919,38219,288138
White,397915,0.000274452,9243,6.38E-06,1/10/21,0.023138513,8176,334617,220562,114055,0,250676,41929,292605
White,403801,0.000278511,9307,6.42E-06,1/11/21,0.025671104,36625,371242,243646,127596,0,257181,57019,314200
White,409082,0.000282154,9569,6.60E-06,1/12/21,0.028521091,41215,412457,266184,146273,0,270305,71106,341411
White,414819,0.000286111,9736,6.72E-06,1/13/21,0.031592285,44414,456871,286676,170195,0,291471,82735,374206
White,421508,0.000290724,9891,6.82E-06,1/14/21,0.034944433,48477,505348,302392,202956,0,327706,88880,416586
White,429258,0.00029607,10091,6.96E-06,1/15/21,0.038988973,58490,563838,321092,242746,0,376339,93840,470179
White,436083,0.000300777,10256,7.07E-06,1/16/21,0.041601984,37788,601626,331857,269769,0,408786,96516,505302
White,441059,0.000304209,10362,7.15E-06,1/17/21,0.043218555,23378,625004,339104,285900,0,429497,97861,527358
White,445062,0.00030697,10428,7.19E-06,1/18/21,0.045841041,37925,662929,356332,306597,0,454565,104311,558876
White,448577,0.000309395,10530,7.26E-06,1/19/21,0.050179464,62742,725671,385267,340404,0,496451,114766,611217
White,452456,0.00031207,10741,7.41E-06,1/20/21,0.055242572,73220,798891,419207,379684,0,547034,126084,673118
White,456733,0.00031502,10976,7.57E-06,1/21/21,0.060976912,82927,881818,453585,428233,0,616838,132662,749500
White,460463,0.000317593,11145,7.69E-06,1/22/21,0.066502282,79905,961723,484624,477099,0,687098,137495,824593
White,464301,0.00032024,11330,7.81E-06,1/23/21,0.070146309,52699,1014422,505697,508725,0,732264,141274,873538
White,469037,0.000323506,11404,7.87E-06,1/24/21,0.072254393,30486,1044908,519058,525850,0,759515,142896,902411
White,471996,0.000325547,11460,7.90E-06,1/25/21,0.0768356,66252,1111160,547455,563705,0,802653,154522,957175
White,475186,0.000327747,11664,8.04E-06,1/26/21,0.082296662,78975,1190135,584390,605745,0,856454,167155,1023609
White,478329,0.000329915,11879,8.19E-06,1/27/21,0.088138182,84477,1274612,625080,649532,0,915762,179712,1095474
White,482025,0.000332464,12045,8.31E-06,1/28/21,0.094291843,88991,1363603,665295,698308,0,982672,190748,1173420
White,485750,0.000335034,12267,8.46E-06,1/29/21,0.099943065,81726,1445329,704003,741326,0,1042991,201392,1244383
White,489390,0.000337544,12423,8.57E-06,1/30/21,0.104255281,62361,1507690,732298,775392,0,1095588,206271,1301859
White,492364,0.000339596,12511,8.63E-06,1/31/21,0.106888692,38083,1545773,754825,790948,0,1130185,208023,1338208
White,494536,0.000341094,12573,8.67E-06,2/1/21,0.111850358,71754,1617527,786840,830687,0,1176763,220612,1397375
White,496550,0.000342483,12761,8.80E-06,2/2/21,0.117710065,84740,1702267,822849,879418,0,1229754,236422,1466176
White,499316,0.000344391,12968,8.94E-06,2/3/21,0.124279243,95000,1797267,865442,931825,0,1287759,254877,1542636
White,502234,0.000346403,13190,9.10E-06,2/4/21,0.131344291,102172,1899439,910167,989272,0,1347987,275783,1623770
White,504843,0.000348203,13361,9.22E-06,2/5/21,0.138600744,104939,2004378,956148,1048230,0,1397983,303140,1701123
White,507681,0.00035016,13485,9.30E-06,2/6/21,0.143683836,73509,2077887,991995,1085892,0,1443675,317130,1760805
White,509892,0.000351685,13578,9.37E-06,2/7/21,0.145971224,33079,2110966,1013935,1097031,0,1463185,323991,1787176
White,511462,0.000352768,13628,9.40E-06,2/8/21,0.151786883,84103,2195069,1057263,1137806,0,1497229,349046,1846275
White,513077,0.000353882,13744,9.48E-06,2/9/21,0.158432955,96112,2291181,1104561,1186620,0,1523127,384342,1907469
White,515005,0.000355212,13918,9.60E-06,2/10/21,0.166272129,113366,2404547,1161113,1243434,0,1538845,433337,1972182
White,517166,0.000356702,14068,9.70E-06,2/11/21,0.174561187,119872,2524419,1222053,1302366,0,1552900,486373,2039273
White,519168,0.000358083,14216,9.81E-06,2/12/21,0.183329035,126796,2651215,1278312,1372903,0,1568912,542174,2111086
White,521073,0.000359397,14348,9.90E-06,2/13/21,0.18902389,82356,2733571,1315341,1418230,0,1579265,578631,2157896
White,522663,0.000360494,14425,9.95E-06,2/14/21,0.192396783,48777,2782348,1338659,1443689,0,1585109,600490,2185599
White,523927,0.000361365,14453,9.97E-06,2/15/21,0.197229001,69884,2852232,1368490,1483742,0,1593048,632235,2225283
White,524753,0.000361935,14542,1.00E-05,2/16/21,0.205613278,121249,2973481,1425791,1547690,0,1599160,690708,2289868
White,526046,0.000362827,14689,1.01E-05,2/17/21,0.214249743,124896,3098377,1487379,1610998,0,1593882,756759,2350641
White,527690,0.000363961,14819,1.02E-05,2/18/21,0.223321778,131195,3229572,1555258,1674314,0,1586708,826784,2413492
White,529334,0.000365095,14958,1.03E-05,2/19/21,0.231372548,116428,3346000,1623297,1722703,0,1584410,886703,2471113
White,530958,0.000366215,15083,1.04E-05,2/20/21,0.236492842,74047,3420047,1670365,1749682,0,1588275,922469,2510744
White,532295,0.000367137,15170,1.05E-05,2/21/21,0.239045418,36916,3456963,1699533,1757430,0,1584356,943615,2527971
White,533145,0.000367723,15205,1.05E-05,2/22/21,0.24440974,77576,3534539,1750861,1783678,0,1580439,985081,2565520
White,534330,0.000368541,15249,1.05E-05,2/23/21,0.251776693,106538,3641077,1806125,1834952,0,1567140,1046923,2614063
White,535706,0.00036949,15648,1.08E-05,2/24/21,0.261059841,134248,3775325,1872728,1902597,0,1553797,1123026,2676823
White,537448,0.000370691,15836,1.09E-05,2/25/21,0.271417914,149792,3925117,1943119,1981998,0,1549312,1202631,2751943
White,538323,0.000371295,15908,1.10E-05,2/26/21,0.282400958,158831,4083948,2014670,2069278,0,1556221,1280340,2836561
White,539466,0.000372083,16017,1.10E-05,2/27/21,0.290098514,111318,4195266,2065273,2129982,11,1563712,1333335,2897047
White,540449,0.000372761,16075,1.11E-05,2/28/21,0.294265101,60256,4255522,2099563,2155947,12,1568182,1362184,2930366
White,541113,0.000373219,16111,1.11E-05,3/1/21,0.301774295,108595,4364117,2158108,2205984,25,1578967,1412329,2991296
White,541927,0.00037378,16205,1.12E-05,3/2/21,0.310390775,124607,4488724,2218975,2269721,28,1596490,1467920,3064410
White,542988,0.000374512,16317,1.13E-05,3/3/21,0.320574868,147277,4636001,2292207,2343750,44,1607281,1538211,3145492
White,544198,0.000375347,16410,1.13E-05,3/4/21,0.331050564,151496,4787497,2367207,2420225,65,1621205,1608894,3230099
White,545388,0.000376168,16505,1.14E-05,3/5/21,0.340618123,138363,4925860,2432569,2492610,681,1643988,1668792,3312780
White,546630,0.000377024,16586,1.14E-05,3/6/21,0.34803113,107203,5033063,2485095,2543757,4211,1659557,1717593,3377150
White,547503,0.000377626,16622,1.15E-05,3/7/21,0.351650747,52346,5085409,2515168,2564160,6081,1665836,1742765,3408601
White,548193,0.000378102,16645,1.15E-05,3/8/21,0.357816509,89166,5174575,2555972,2607304,11299,1690495,1778817,3469312
White,550247,0.000379519,16739,1.15E-05,3/9/21,0.365501064,111131,5285706,2602630,2664371,18705,1695760,1836726,3532486
White,550982,0.000380026,16834,1.16E-05,3/10/21,0.374502153,130170,5415876,2666708,2720233,28935,1702718,1904768,3607486
White,552040,0.000380756,16906,1.17E-05,3/11/21,0.385101557,153285,5569161,2740235,2786435,42491,1705587,1987832,3693419
White,553035,0.000381442,16972,1.17E-05,3/12/21,0.39583345,155199,5724360,2807548,2856685,60127,1701097,2077198,3778295
White,553898,0.000382037,16995,1.17E-05,3/13/21,0.403281931,107716,5832076,2854020,2908168,69888,1705797,2134440,3840237
White,554628,0.000382541,17010,1.17E-05,3/14/21,0.407438838,60115,5892191,2884760,2933533,73898,1709342,2165196,3874538
White,555045,0.000382828,17028,1.17E-05,3/15/21,0.415569959,117590,6009781,2940734,2988474,80573,1715627,2224831,3940458
White,555879,0.000383403,17120,1.18E-05,3/16/21,0.426046416,151505,6161286,3011816,3062791,86679,1734622,2294810,4029432
White,556746,0.000384001,17202,1.19E-05,3/17/21,0.436478686,150867,6312153,3087589,3131487,93077,1764420,2359073,4123493
White,557745,0.00038469,17281,1.19E-05,3/18/21,0.447442437,158552,6470705,3170693,3200914,99098,1792990,2427615,4220605
White,558680,0.000385335,17265,1.19E-05,3/19/21,0.458066596,153643,6624348,3252710,3264988,106650,1819885,2495195,4315080
White,559739,0.000386066,17294,1.19E-05,3/20/21,0.465349879,105332,6729680,3309141,3309238,111301,1847746,2536638,4384384
White,560434,0.000386545,17435,1.20E-05,3/21/21,0.469107311,54338,6784018,3347082,3323361,113575,1864185,2557330,4421515
White,560887,0.000386858,17457,1.20E-05,3/22/21,0.476413828,105677,6889695,3411522,3361031,117142,1897429,2596061,4493490
White,561478,0.000387265,17548,1.21E-05,3/23/21,0.485888035,137018,7026713,3488540,3417403,120770,1933269,2648891,4582160
White,562217,0.000387775,17619,1.22E-05,3/24/21,0.496091352,147559,7174272,3576052,3473589,124631,1953320,2714969,4668289
White,563121,0.000388398,17688,1.22E-05,3/25/21,0.506988167,157583,7331855,3664803,3538648,128404,1973064,2786018,4759082
White,564332,0.000389234,17750,1.22E-05,3/26/21,0.517923636,158148,7490003,3751100,3606037,132866,1984648,2861907,4846555
White,565221,0.000389847,17816,1.23E-05,3/27/21,0.52548158,109299,7599302,3807919,3654846,136537,1981117,2920488,4901605
White,566013,0.000390393,17823,1.23E-05,3/28/21,0.529632955,60036,7659338,3845104,3676545,137689,1986920,2948505,4935425
White,566700,0.000390867,17826,1.23E-05,3/29/21,0.537605932,115303,7774641,3906104,3728234,140303,2001872,3000420,5002292
White,567405,0.000391353,17881,1.23E-05,3/30/21,0.547814297,147628,7922269,3979466,3797243,145560,2035321,3060423,5095744
White,568169,0.00039188,17932,1.24E-05,3/31/21,0.558585537,155769,8078038,4064372,3860441,153225,2059530,3130119,5189649
White,569110,0.000392529,17992,1.24E-05,4/1/21,0.571380636,185040,8263078,4159866,3935089,168123,2094700,3212615,5307315
White,570279,0.000393335,18021,1.24E-05,4/2/21,0.583241323,171529,8434607,4245481,4005282,183844,2125312,3291123,5416435
White,571125,0.000393919,18073,1.25E-05,4/3/21,0.590974559,111837,8546444,4302316,4046243,197885,2137756,3348023,5485779
White,571882,0.000394441,18081,1.25E-05,4/4/21,0.594112621,45392,8591836,4325680,4061712,204444,2139651,3373068,5512719
White,572450,0.000394833,18068,1.25E-05,4/5/21,0.603227737,131824,8723660,4394483,4110412,218765,2153620,3439609,5593229
White,573154,0.000395318,18107,1.25E-05,4/6/21,0.614920874,169101,8892761,4481133,4168754,242874,2171765,3527608,5699373
White,573934,0.000395856,18159,1.25E-05,4/7/21,0.626686342,170149,9062910,4572524,4222797,267589,2191695,3615376,5807071
White,574807,0.000396459,18214,1.26E-05,4/8/21,0.639171722,180559,9243469,4665205,4281032,297232,2206833,3713357,5920190
White,576131,0.000397372,18254,1.26E-05,4/9/21,0.650734444,167220,9410689,4751595,4335672,323422,2216152,3806095,6022247
White,577428,0.000398266,18274,1.26E-05,4/10/21,0.658415335,111098,9521787,4802586,4374854,344347,2215398,3873162,6088560
White,578221,0.000398813,18285,1.26E-05,4/11/21,0.662654046,61320,9583107,4836179,4391937,354991,2211674,3911841,6123515
White,578757,0.000399183,18277,1.26E-05,4/12/21,0.670633108,115391,9698498,4896242,4434348,367908,2210357,3977394,6187751
White,579375,0.000399609,18269,1.26E-05,4/13/21,0.680802265,147062,9845560,4976409,4500986,368165,2215896,4049029,6264925
White,580054,0.000400077,18317,1.26E-05,4/14/21,0.691241243,150981,9996541,5060731,4567576,368234,2214119,4126655,6340774
White,580850,0.000400627,18325,1.26E-05,4/15/21,0.702672443,165330,10161871,5156909,4636655,368307,2225386,4204422,6429808
White,581832,0.000401304,18344,1.27E-05,4/16/21,0.71329923,153690,10315561,5243700,4703463,368398,2228103,4280367,6508470
White,582705,0.000401906,18365,1.27E-05,4/17/21,0.720100335,98386,10413947,5297789,4747750,368408,2232276,4328227,6560503
White,583309,0.000402323,18371,1.27E-05,4/18/21,0.723463063,48632,10462579,5327359,4766809,368411,2231267,4353719,6584986
White,583815,0.000402672,18383,1.27E-05,4/19/21,0.730963889,108475,10571054,5390401,4812225,368428,2219003,4414589,6633592
White,584471,0.000403124,18406,1.27E-05,4/20/21,0.740424198,136831,10707885,5462213,4877239,368433,2210567,4488178,6698745
White,585252,0.000403663,18444,1.27E-05,4/21/21,0.749932219,137523,10845408,5541258,4935617,368533,2195794,4565287,6761081
White,585770,0.00040402,18466,1.27E-05,4/22/21,0.76021084,149891,10995299,5628587,4998159,368553,2168925,4654907,6823832
White,586286,0.000404376,18480,1.27E-05,4/23/21,0.769906324,140311,11135610,5712066,5054971,368573,2143671,4739837,6883508
White,586823,0.000404746,18494,1.28E-05,4/24/21,0.77629613,92414,11228024,5770958,5088435,368631,2133109,4792847,6925956
White,587420,0.000405158,18501,1.28E-05,4/25/21,0.779414484,45099,11273123,5800252,5104211,368660,2130255,4817213,6947468
White,587870,0.000405468,18502,1.28E-05,4/26/21,0.785395133,86502,11359625,5850590,5139851,369184,2111628,4871726,6983354
White,588338,0.000405791,18491,1.28E-05,4/27/21,0.793182099,112682,11472307,5911063,5189545,371699,2083291,4945172,7028463